title: Có nên mua Samsung Galaxy S22 Ultra thời điểm này? Câu trả lời là…	title : Có nên mua Samsung Galaxy S22 Ultra thời điểm này ? Câu trả lời là …

Samsung Galaxy S22 Ultra là sản phẩm tốt nhất thế giới Android hiện nay.	Samsung Galaxy S22 Ultra là sản phẩm tốt nhất thế giới Android hiện nay .
{"subject": ["1&&Samsung", "2&&Galaxy", "3&&S22", "4&&Ultra"], "object": [], "aspect": [], "predicate": ["8&&tốt", "9&&nhất", "10&&thế", "11&&giới", "12&&Android", "13&&hiện", "14&&nay"], "label": "SUP+"}

Điều này không cần bàn luận gì thêm.	Điều này không cần bàn luận gì thêm .

Tuy nhiên, chỉ có một câu hỏi đặt ra: Liệu có nên mua Galaxy S22 Ultra ngay thời điểm này?	Tuy nhiên , chỉ có một câu hỏi đặt ra : Liệu có nên mua Galaxy S22 Ultra ngay thời điểm này ?

Hi vọng bài viết sau đây của Hoàng Hà Mobile sẽ giúp khách hàng đang quan tâm về siêu phẩm này sẽ có sự lựa chọn chính xác!	Hi vọng bài viết sau đây của Hoàng Hà Mobile sẽ giúp khách hàng đang quan tâm về siêu phẩm này sẽ có sự lựa chọn chính xác !

Màn hình độ sáng & độ mượt tuyệt vời!	Màn hình độ sáng & độ mượt tuyệt vời !

Độ sáng cực cao đến 1.750 nits	Độ sáng cực cao đến 1.750 nits

Dòng Galaxy S22 series tự hào có một số cải tiến về hiển thị, nổi bật là nỗ lực tạo ra màn hình sáng nhất trên bất kỳ điện thoại thông minh nào.Trong trường hợp của Galaxy S22 Ultra, điều đó có nghĩa là màn hình hứa hẹn có độ sáng cao nhất là 1.750 nits.	Dòng Galaxy S22 series tự hào có một số cải tiến về hiển thị , nổi bật là nỗ lực tạo ra màn hình sáng nhất trên bất kỳ điện thoại thông minh nào.Trong trường hợp của Galaxy S22 Ultra , điều đó có nghĩa là màn hình hứa hẹn có độ sáng cao nhất là 1.750 nits .
{"subject": ["1&&Dòng", "2&&Galaxy", "3&&S22", "4&&series"], "object": [], "aspect": ["23&&màn", "24&&hình"], "predicate": ["25&&sáng", "26&&nhất", "27&&trên", "28&&bất", "29&&kỳ", "30&&điện", "31&&thoại", "32&&thông", "33&&minh", "34&&nào.Trong"], "label": "SUP+"}

Và với tính năng Vision Booster của Samsung, Galaxy S22 Ultra sẽ điều chỉnh màn hình hiển thị và cân bằng màu sắc dựa trên ánh sáng xung quanh.	Và với tính năng Vision Booster của Samsung , Galaxy S22 Ultra sẽ điều chỉnh màn hình hiển thị và cân bằng màu sắc dựa trên ánh sáng xung quanh .

Bạn không cần phải đi sâu vào cài đặt của điện thoại để có được sự hiển thị vừa mắt nhất.	Bạn không cần phải đi sâu vào cài đặt của điện thoại để có được sự hiển thị vừa mắt nhất .

Mùa hè đã tới rồi, nếu bạn hay sử dụng điện thoại ngoài trời nắng, màn hình cực sáng của sản phẩm này sẽ không làm bạn thất vọng đâu!	Mùa hè đã tới rồi , nếu bạn hay sử dụng điện thoại ngoài trời nắng , màn hình cực sáng của sản phẩm này sẽ không làm bạn thất vọng đâu !

alt: s22	alt : s22

des:	des :

Tần số quét 120Hz linh hoạt cải thiện thời lượng pin	Tần số quét 120Hz linh hoạt cải thiện thời lượng pin

Galaxy S21 Ultra năm ngoái có thể điều chỉnh tần số quét nằm trong khoảng từ 10Hz đến 120Hz, nhưng Galaxy S22 Ultra còn điều chỉnh hơn nữa.	Galaxy S21 Ultra năm ngoái có thể điều chỉnh tần số quét nằm trong khoảng từ 10Hz đến 120Hz , nhưng Galaxy S22 Ultra còn điều chỉnh hơn nữa .
{"subject": ["22&&Galaxy", "23&&S22", "24&&Ultra"], "object": ["1&&Galaxy", "2&&S21", "3&&Ultra"], "aspect": ["10&&tần", "11&&số", "12&&quét"], "predicate": ["26&&điều", "27&&chỉnh", "28&&hơn", "29&&nữa"], "label": "COM"}

Điện thoại này vẫn có thể đạt 120Hz khi cần thiết, nhưng khi ở những thời điểm khác, tốc độ làm mới có thể giảm xuống mức 1Hz.	Điện thoại này vẫn có thể đạt 120Hz khi cần thiết , nhưng khi ở những thời điểm khác , tốc độ làm mới có thể giảm xuống mức 1Hz .

alt: s22	alt : s22

des:	des :

Điều chỉnh thông minh này sẽ cải thiện thời lượng pin cho máy.	Điều chỉnh thông minh này sẽ cải thiện thời lượng pin cho máy .

Dòng S21 Ultra hoạt động trong thời gian khá tốt, nhưng đôi lúc vẫn phải chỉnh xuống 60Hz nếu muốn kéo dài thời gian dùng thêm 1 giờ.	Dòng S21 Ultra hoạt động trong thời gian khá tốt , nhưng đôi lúc vẫn phải chỉnh xuống 60Hz nếu muốn kéo dài thời gian dùng thêm 1 giờ .

Galaxy S22 Ultra, với tốc độ làm tươi được cải thiện, có thể giúp quản lý mức tiêu thụ điện năng một cách khéo léo hơn.	Galaxy S22 Ultra , với tốc độ làm tươi được cải thiện , có thể giúp quản lý mức tiêu thụ điện năng một cách khéo léo hơn .
{"subject": ["1&&Galaxy", "2&&S22", "3&&Ultra"], "object": [], "aspect": ["17&&quản", "18&&lý", "19&&mức", "20&&tiêu", "21&&thụ", "22&&điện", "23&&năng"], "predicate": ["26&&khéo", "27&&léo", "28&&hơn"], "label": "COM+"}

Lần đầu tiên, bút S-Pen có sẵn!	Lần đầu tiên , bút S-Pen có sẵn !

Nói về Galaxy S21 Ultra, đây là điện thoại đầu tiên ngoài dòng Galaxy Note hỗ trợ bút S-Pen của Samsung.	Nói về Galaxy S21 Ultra , đây là điện thoại đầu tiên ngoài dòng Galaxy Note hỗ trợ bút S-Pen của Samsung .

Tuy nhiên, S-Pen là phụ kiện tùy chọn của S21 Ultra nên nó không được tích hợp trực tiếp vào máy!	Tuy nhiên , S-Pen là phụ kiện tùy chọn của S21 Ultra nên nó không được tích hợp trực tiếp vào máy !

Đó không phải là vấn đề với Galaxy S22 Ultra, vì máy sẽ bao gồm một khe cắm cho bút S-Pen.	Đó không phải là vấn đề với Galaxy S22 Ultra , vì máy sẽ bao gồm một khe cắm cho bút S-Pen .

Điều đó có nghĩa là bạn không phải tìm kiếm một chiếc hộp đựng bút cảm ứng, chỉ cần bật nó ra khỏi điện thoại và ghi ngay các ghi chú ngay trên màn hình của máy.	Điều đó có nghĩa là bạn không phải tìm kiếm một chiếc hộp đựng bút cảm ứng , chỉ cần bật nó ra khỏi điện thoại và ghi ngay các ghi chú ngay trên màn hình của máy .

alt: The-Samsung-Galaxy-S22-Ultra-has-a-6.8-inch-screen-scaled	alt : The-Samsung-Galaxy-S22 - Ultra-has-a - 6.8 - inch-screen-scaled

des:	des :

S-Pen đi kèm với Galaxy S22 Ultra cũng nhanh hơn trước, với tốc độ cải thiện 70% và độ trễ ít hơn.	S-Pen đi kèm với Galaxy S22 Ultra cũng nhanh hơn trước , với tốc độ cải thiện 70% và độ trễ ít hơn .
{"subject": ["1&&S-Pen", "2&&đi", "3&&kèm", "4&&với", "5&&Galaxy", "6&&S22", "7&&Ultra"], "object": [], "aspect": [], "predicate": ["9&&nhanh", "10&&hơn"], "label": "COM+"}
{"subject": ["1&&S-Pen", "2&&đi", "3&&kèm", "4&&với", "5&&Galaxy", "6&&S22", "7&&Ultra"], "object": [], "aspect": ["20&&độ", "21&&trễ"], "predicate": ["22&&ít", "23&&hơn"], "label": "COM+"}
{"subject": ["1&&S-Pen", "2&&đi", "3&&kèm", "4&&với", "5&&Galaxy", "6&&S22", "7&&Ultra"], "object": [], "aspect": ["14&&tốc", "15&&độ"], "predicate": ["16&&cải", "17&&thiện", "18&&70%"], "label": "COM+"}

Đưa vào các tính năng chuyển đổi chữ viết tay thành văn bản, bút stylus chính xác hơn được tích hợp vào Microsoft Outlook – đây là một bổ sung đáng hoan nghênh cho mẫu Ultra của Galaxy S, đặc biệt nếu bạn xem điện thoại của mình như một công cụ đồng hành trong công việc.	Đưa vào các tính năng chuyển đổi chữ viết tay thành văn bản , bút stylus chính xác hơn được tích hợp vào Microsoft Outlook – đây là một bổ sung đáng hoan nghênh cho mẫu Ultra của Galaxy S , đặc biệt nếu bạn xem điện thoại của mình như một công cụ đồng hành trong công việc .

Sạc nhanh 45W được khôi phục	Sạc nhanh 45W được khôi phục

Sau khi cung cấp tính năng sạc 45W trên Galaxy S20 Ultra năm 2020, Samsung đã quay trở lại sạc 25W trong mô hình 2021.	Sau khi cung cấp tính năng sạc 45W trên Galaxy S20 Ultra năm 2020 , Samsung đã quay trở lại sạc 25W trong mô hình 2021 .

Thế hệ Galaxy S22 Ultra đảo ngược hướng đi đó và tốc độ sạc 45W một lần nữa được khôi phục trên điện thoại cao cấp của Samsung.	Thế hệ Galaxy S22 Ultra đảo ngược hướng đi đó và tốc độ sạc 45W một lần nữa được khôi phục trên điện thoại cao cấp của Samsung .

Với tốc độ đó, bạn sẽ có thể sạc đầy Galaxy S22 Ultra đến 50% chỉ sau 20 phút.	Với tốc độ đó , bạn sẽ có thể sạc đầy Galaxy S22 Ultra đến 50% chỉ sau 20 phút .

Tốc độ này nhanh hơn 10 phút so với những gì S21 Ultra cần để đạt được mốc đó.	Tốc độ này nhanh hơn 10 phút so với những gì S21 Ultra cần để đạt được mốc đó .
{"subject": [], "object": ["12&&S21", "13&&Ultra"], "aspect": ["1&&Tốc", "2&&độ", "3&&này"], "predicate": ["4&&nhanh", "5&&hơn"], "label": "COM+"}

Galaxy S22 Ultra cũng nhanh gấp đôi tốc độ sạc cao nhất của iPhone 13 Pro Max.	Galaxy S22 Ultra cũng nhanh gấp đôi tốc độ sạc cao nhất của iPhone 13 Pro Max .
{"subject": ["1&&Galaxy", "2&&S22", "3&&Ultra"], "object": ["14&&iPhone", "15&&13", "16&&Pro", "17&&Max"], "aspect": ["8&&tốc", "9&&độ", "10&&sạc", "11&&cao", "12&&nhất"], "predicate": ["5&&nhanh", "6&&gấp", "7&&đôi"], "label": "COM+"}

alt: s22	alt : s22

des:	des :

Galaxy S22 Ultra chụp ảnh tốt hơn trong điều kiện thiếu sáng	Galaxy S22 Ultra chụp ảnh tốt hơn trong điều kiện thiếu sáng
{"subject": ["1&&Galaxy", "2&&S22", "3&&Ultra"], "object": [], "aspect": ["4&&chụp", "5&&ảnh"], "predicate": ["6&&tốt", "7&&hơn"], "label": "COM+"}

Chỉ nhìn vào thông số megapixel cho camera của Galaxy S22 Ultra, có vẻ như không có nhiều thay đổi so với Galaxy S21 Ultra.	Chỉ nhìn vào thông số megapixel cho camera của Galaxy S22 Ultra , có vẻ như không có nhiều thay đổi so với Galaxy S21 Ultra .
{"subject": ["8&&camera", "9&&của", "10&&Galaxy", "11&&S22", "12&&Ultra"], "object": ["24&&Galaxy", "25&&S21", "26&&Ultra"], "aspect": ["4&&thông", "5&&số", "6&&megapixel"], "predicate": ["17&&không", "18&&có", "19&&nhiều", "20&&thay", "21&&đổi"], "label": "EQL"}

Nhưng điều đó không đúng.	Nhưng điều đó không đúng .

Máy ảnh chính 108MP trên điện thoại mới hiện sử dụng cảm biến 2,4um lớn hơn để thu được nhiều ánh sáng và dữ liệu hơn.	Máy ảnh chính 108MP trên điện thoại mới hiện sử dụng cảm biến 2,4um lớn hơn để thu được nhiều ánh sáng và dữ liệu hơn .
{"subject": ["1&&Máy", "2&&ảnh", "3&&chính", "4&&108MP", "5&&trên", "6&&điện", "7&&thoại", "8&&mới"], "object": [], "aspect": ["12&&cảm", "13&&biến"], "predicate": ["15&&lớn", "16&&hơn"], "label": "COM+"}

Samsung cũng đã giới thiệu ống kính Super Clear Glass để chụp ảnh ít chói và lóa ống kính vào ban đêm.	Samsung cũng đã giới thiệu ống kính Super Clear Glass để chụp ảnh ít chói và lóa ống kính vào ban đêm .

alt: s22-ultra-rear-scaled	alt : s22 - ultra-rear-scaled

des:	des :

Ảnh chụp từ Galaxy S22 Ultra có độ chân thực cao, độ chi tiết cao không cần phải bàn tới.	Ảnh chụp từ Galaxy S22 Ultra có độ chân thực cao , độ chi tiết cao không cần phải bàn tới .

Đôi khi trong một vài trường hợp nếu đặt cạnh ảnh chụp của một chiếc máy ảnh với các ống kính chuyên dụng, không phải ai cũng phân biệt được đâu là ảnh từ một chiếc smartphone, hay đâu là ảnh chụp từ một chiếc máy ảnh, kể cả khi zoom lên từng góc cạnh.	Đôi khi trong một vài trường hợp nếu đặt cạnh ảnh chụp của một chiếc máy ảnh với các ống kính chuyên dụng , không phải ai cũng phân biệt được đâu là ảnh từ một chiếc smartphone , hay đâu là ảnh chụp từ một chiếc máy ảnh , kể cả khi zoom lên từng góc cạnh .

Camera trên Galaxy S22 Ultra còn có khả năng xử lý HDR tốt tới ấn tượng, cứu lại được vùng sáng và tối một cách hài hòa nhất.	Camera trên Galaxy S22 Ultra còn có khả năng xử lý HDR tốt tới ấn tượng , cứu lại được vùng sáng và tối một cách hài hòa nhất .

Những chuyên gia dùng điện thoại chụp ảnh sẽ rất hài lòng với sản phẩm này.	Những chuyên gia dùng điện thoại chụp ảnh sẽ rất hài lòng với sản phẩm này .

Mùa nghỉ lễ đang diễn ra, bạn đừng bỏ lỡ cơ hội lưu lại khoảnh khắc của những chuyến đi nhé.	Mùa nghỉ lễ đang diễn ra , bạn đừng bỏ lỡ cơ hội lưu lại khoảnh khắc của những chuyến đi nhé .

Cấu hình gây tò mò	Cấu hình gây tò mò

Tại sao lại gây tò mò?	Tại sao lại gây tò mò ?

Đơn giản vì không có nhiều cơ hội để bạn mua Samsung dòng S chính hãng ở Việt Nam mà lại dùng Snapdragon.	Đơn giản vì không có nhiều cơ hội để bạn mua Samsung dòng S chính hãng ở Việt Nam mà lại dùng Snapdragon .

Bạn đã biết Exynos trong nhiều năm qua, vậy thì chần chừ gì mà không trải nghiệm một sự thay đổi của Samsung?	Bạn đã biết Exynos trong nhiều năm qua , vậy thì chần chừ gì mà không trải nghiệm một sự thay đổi của Samsung ?

alt: galaxy_s22_ultra	alt : galaxy_s22 _ ultra

des:	des :

Đó là một chiếc điện thoại rất nhanh và mạnh mẽ.	Đó là một chiếc điện thoại rất nhanh và mạnh mẽ .

Bộ xử lý 4nm của Qualcomm Snapdragon 8 Gen1 sẽ càn quét mọi ứng dụng hiện nay.	Bộ xử lý 4nm của Qualcomm Snapdragon 8 Gen1 sẽ càn quét mọi ứng dụng hiện nay .

Đây cũng là một chiếc điện thoại chơi game tuyệt đẹp và khá mạnh mẽ, và đã xử lý những game như PUBG, Liên Quân Mobile,… mà không gặp một trục trặc nào.	Đây cũng là một chiếc điện thoại chơi game tuyệt đẹp và khá mạnh mẽ , và đã xử lý những game như PUBG , Liên Quân Mobile , … mà không gặp một trục trặc nào .

Tất nhiên, điện thoại sẽ ấm lên nhưng không khó chịu, không có tác động lớn đến tốc độ khung hình, ngay cả ở cài đặt đồ họa cao nhất.	Tất nhiên , điện thoại sẽ ấm lên nhưng không khó chịu , không có tác động lớn đến tốc độ khung hình , ngay cả ở cài đặt đồ họa cao nhất .

Đừng quên Samsung có thể cập nhật nhiều lần để “buff” hiệu năng lên nữa đấy!	Đừng quên Samsung có thể cập nhật nhiều lần để “ buff ” hiệu năng lên nữa đấy !

Sau đây là những lý do tổng hợp để bạn mua ngay Samsung Galaxy S22 Ultra ngay hôm nay:	Sau đây là những lý do tổng hợp để bạn mua ngay Samsung Galaxy S22 Ultra ngay hôm nay :

Sản phẩm cao cấp nhất của thế giới Android hiện nay	Sản phẩm cao cấp nhất của thế giới Android hiện nay
{"subject": ["1&&Sản", "2&&phẩm"], "object": [], "aspect": [], "predicate": ["3&&cao", "4&&cấp", "5&&nhất", "6&&của", "7&&thế", "8&&giới", "9&&Android", "10&&hiện", "11&&nay"], "label": "SUP+"}

- Cấu hình được cải tiến với Qualcomm Snapdragon 8 Gen1	- Cấu hình được cải tiến với Qualcomm Snapdragon 8 Gen1

- Camera tuyệt vời chụp đêm ấn tượng	- Camera tuyệt vời chụp đêm ấn tượng

- Bút S-Pen “thần thánh”	- Bút S-Pen “ thần thánh ”

- Bạn vẫn yêu dòng Note truyền thống	- Bạn vẫn yêu dòng Note truyền thống

- Mức giá cực tốt cùng nhiều ưu đãi	- Mức giá cực tốt cùng nhiều ưu đãi

