title: Đánh giá chi tiết Samsung Galaxy A14 5G: Có gì đáng để mong đợi?	title : Đánh giá chi tiết Samsung Galaxy A14 5G : Có gì đáng để mong đợi ?

Điện thoại Samsung  là thương hiệu nổi tiếng đến từ Hàn Quốc, với nhiều dòng  điện thoại  nổi tiếng ở nhiều phân khúc khác nhau.	Điện thoại Samsung là thương hiệu nổi tiếng đến từ Hàn Quốc , với nhiều dòng điện thoại nổi tiếng ở nhiều phân khúc khác nhau .

Mới đây, Samsung vừa cho ra mắt dòng  điện thoại Samsung Galaxy A14 5G .	Mới đây , Samsung vừa cho ra mắt dòng điện thoại Samsung Galaxy A14 5G .

Cùng tìm hiểu và đánh giá chi tiết Samsung Galaxy A14 5G: Có gì đáng để mong đợi nhé!	Cùng tìm hiểu và đánh giá chi tiết Samsung Galaxy A14 5G : Có gì đáng để mong đợi nhé !

1.	1 .

Tổng quan về điện thoại Samsung Galaxy A14 5G	Tổng quan về điện thoại Samsung Galaxy A14 5G

Samsung Galaxy A14 5G có thể là chiếc smartphone đầu tiên của năm 2023 được nhà sản xuất đến từ Hàn Quốc phát hành chính thức ở Việt Nam, lấy cảm hứng thiết kế từ những mẫu  điện thoại Samsung dòng A  trước đây với mặt lưng phẳng, màn hình giọt nước cùng cụm camera xếp dọc.	Samsung Galaxy A14 5G có thể là chiếc smartphone đầu tiên của năm 2023 được nhà sản xuất đến từ Hàn Quốc phát hành chính thức ở Việt Nam , lấy cảm hứng thiết kế từ những mẫu điện thoại Samsung dòng A trước đây với mặt lưng phẳng , màn hình giọt nước cùng cụm camera xếp dọc .

Kích thước màn hình thì sẽ là 6.6 inch nên bạn có thể thoải mái hơn trong việc xem phim trên một không gian lớn.	Kích thước màn hình thì sẽ là 6.6 inch nên bạn có thể thoải mái hơn trong việc xem phim trên một không gian lớn .
{"subject": [], "object": [], "aspect": ["19&&xem", "20&&phim"], "predicate": ["14&&thoải", "15&&mái", "16&&hơn"], "label": "COM+"}

Bên cạnh đó thì hãng còn hỗ trợ thêm cho máy tần số quét 90 Hz, nó giúp bạn có thể thao tác mượt mà hơn với những cử chỉ cuộn/lướt quen thuộc hằng ngày.	Bên cạnh đó thì hãng còn hỗ trợ thêm cho máy tần số quét 90 Hz , nó giúp bạn có thể thao tác mượt mà hơn với những cử chỉ cuộn / lướt quen thuộc hằng ngày .
{"subject": ["11&&máy"], "object": [], "aspect": ["23&&thao", "24&&tác"], "predicate": ["25&&mượt", "26&&mà", "27&&hơn"], "label": "COM+"}

alt: Màn hình giọt nước cùng cụm camera xếp dọc	alt : Màn hình giọt nước cùng cụm camera xếp dọc

des: Màn hình giọt nước cùng cụm camera xếp dọc	des : Màn hình giọt nước cùng cụm camera xếp dọc

2.	2 .

Những điểm nổi bật của điện thoại Samsung Galaxy A14 5G	Những điểm nổi bật của điện thoại Samsung Galaxy A14 5G

Thiết kế quen thuộc	Thiết kế quen thuộc

Điện thoại Samsung Galaxy A14 5G được làm chủ yếu từ nhựa và hoàn thiện theo kiểu vân nổi bao phủ lên toàn bộ phần mặt lưng, điều này vừa giúp máy tăng thêm độ bền bỉ nhưng cũng vừa giúp bạn có thể cầm nắm chắc hơn.	Điện thoại Samsung Galaxy A14 5G được làm chủ yếu từ nhựa và hoàn thiện theo kiểu vân nổi bao phủ lên toàn bộ phần mặt lưng , điều này vừa giúp máy tăng thêm độ bền bỉ nhưng cũng vừa giúp bạn có thể cầm nắm chắc hơn .

Mẫu điện thoại có thiết kế vuông sang trọng, tinh tế không khác gì những chiếc smartphone cao cấp trên thị trường.	Mẫu điện thoại có thiết kế vuông sang trọng , tinh tế không khác gì những chiếc smartphone cao cấp trên thị trường .
{"subject": ["1&&Mẫu", "2&&điện", "3&&thoại"], "object": ["16&&những", "17&&chiếc", "18&&smartphone", "19&&cao", "20&&cấp", "21&&trên", "22&&thị", "23&&trường"], "aspect": ["5&&thiết", "6&&kế", "7&&vuông"], "predicate": ["8&&sang", "9&&trọng", "10&&,", "11&&tinh", "12&&tế", "13&&không", "14&&khác", "15&&gì"], "label": "EQL"}

Phần camera được làm liền mạch cùng khung nguyên khối, tạo cảm giác cầm nắm chắc chắn, vừa vặn.	Phần camera được làm liền mạch cùng khung nguyên khối , tạo cảm giác cầm nắm chắc chắn , vừa vặn .

Cảm biến vân tay được đặt ngay nút nguồn, giúp việc mở khóa nhanh chóng, tiện lợi và an toàn.	Cảm biến vân tay được đặt ngay nút nguồn , giúp việc mở khóa nhanh chóng , tiện lợi và an toàn .

alt: Thiết kế vuông sang trọng, tinh tế	alt : Thiết kế vuông sang trọng , tinh tế

des: Thiết kế vuông sang trọng, tinh tế	des : Thiết kế vuông sang trọng , tinh tế

Trải nghiệm thị giác cực đã	Trải nghiệm thị giác cực đã

Tấm nền PLS LCD với ưu điểm là tái hiện hình ảnh có độ sáng cao, màu sắc trung thực và góc nhìn rộng.	Tấm nền PLS LCD với ưu điểm là tái hiện hình ảnh có độ sáng cao , màu sắc trung thực và góc nhìn rộng .

Về độ chi tiết thì hình ảnh hiển thị trên điện thoại là cực kỳ sắc nét nhờ có độ phân giải Full HD+.	Về độ chi tiết thì hình ảnh hiển thị trên điện thoại là cực kỳ sắc nét nhờ có độ phân giải Full HD + .

Hơn hết, Samsung cũng tích hợp sẵn tần số quét 90Hz cho trải nghiệm mượt mà, hơn hẳn các đại diện khác chỉ có 60Hz, giúp bạn hạn chế tình trạng răng cưa hay hỗ trợ cài đặt nhiều mức đồ họa cao hơn khi chơi game.	Hơn hết , Samsung cũng tích hợp sẵn tần số quét 90Hz cho trải nghiệm mượt mà , hơn hẳn các đại diện khác chỉ có 60Hz , giúp bạn hạn chế tình trạng răng cưa hay hỗ trợ cài đặt nhiều mức đồ họa cao hơn khi chơi game .
{"subject": ["4&&Samsung"], "object": ["21&&các", "22&&đại", "23&&diện", "24&&khác"], "aspect": ["9&&tần", "10&&số", "11&&quét"], "predicate": ["19&&hơn", "20&&hẳn"], "label": "COM+"}

alt: Tái hiện hình ảnh có độ sáng cao	alt : Tái hiện hình ảnh có độ sáng cao

des: Tái hiện hình ảnh có độ sáng cao	des : Tái hiện hình ảnh có độ sáng cao

alt: Là chiếc smartphone dành cho người dùng trẻ	alt : Là chiếc smartphone dành cho người dùng trẻ

des: Là chiếc smartphone dành cho người dùng trẻ	des : Là chiếc smartphone dành cho người dùng trẻ

Trong đó, camera chính đạt độ phân giải 50MP cho ảnh sắc nét và rõ ràng.	Trong đó , camera chính đạt độ phân giải 50MP cho ảnh sắc nét và rõ ràng .

Kèm theo đó sẽ là các tính năng chụp ảnh hữu dụng như siêu độ phân giải, xóa phông hay macro để bạn có thể thỏa sức sáng tạo trước những khung cảnh tuyệt đẹp với đa dạng phong cách chụp hơn.	Kèm theo đó sẽ là các tính năng chụp ảnh hữu dụng như siêu độ phân giải , xóa phông hay macro để bạn có thể thỏa sức sáng tạo trước những khung cảnh tuyệt đẹp với đa dạng phong cách chụp hơn .

alt: Là chiếc smartphone dành cho người dùng trẻ	alt : Là chiếc smartphone dành cho người dùng trẻ

des: Là chiếc smartphone dành cho người dùng trẻ	des : Là chiếc smartphone dành cho người dùng trẻ

Đáp ứng mọi tác vụ	Đáp ứng mọi tác vụ

Trang bị trên chiếc điện thoại Samsung Galaxy A14 5G này là con chip MediaTek Dimensity 700 với tám nhân, điều này giúp máy có thể duy trì sự ổn định khi sử dụng các tác vụ từ lướt web, xem phim và cho đến chơi game.	Trang bị trên chiếc điện thoại Samsung Galaxy A14 5G này là con chip MediaTek Dimensity 700 với tám nhân , điều này giúp máy có thể duy trì sự ổn định khi sử dụng các tác vụ từ lướt web , xem phim và cho đến chơi game .

Đây cũng là phiên bản 5G giá tốt nhất của hãng từ trước đến nay.	Đây cũng là phiên bản 5G giá tốt nhất của hãng từ trước đến nay .
{"subject": ["1&&Đây"], "object": [], "aspect": ["7&&giá"], "predicate": ["8&&tốt", "9&&nhất", "10&&của", "11&&hãng", "12&&từ", "13&&trước", "14&&đến", "15&&nay"], "label": "SUP+"}

Bên cạnh 4 GB RAM có sẵn, người dùng cũng có thể mở rộng RAM bằng tính năng RAM Plus, cho phép tăng lên 4 GB RAM, tổng RAM đạt được là 8 GB.	Bên cạnh 4 GB RAM có sẵn , người dùng cũng có thể mở rộng RAM bằng tính năng RAM Plus , cho phép tăng lên 4 GB RAM , tổng RAM đạt được là 8 GB .

alt: Giúp máy có thể duy trì sự ổn định	alt : Giúp máy có thể duy trì sự ổn định

des: Giúp máy có thể duy trì sự ổn định	des : Giúp máy có thể duy trì sự ổn định

Viên pin cho cả ngày dài	Viên pin cho cả ngày dài

Cung cấp năng lượng cho điện thoại sẽ là viên pin dung lượng 5000 mAh khá ấn tượng, đủ cho một ngày dài sử dụng trong việc lướt web hay xem phim.	Cung cấp năng lượng cho điện thoại sẽ là viên pin dung lượng 5000 mAh khá ấn tượng , đủ cho một ngày dài sử dụng trong việc lướt web hay xem phim .

Còn đối với những bạn chỉ sử dụng để nghe gọi hay trả lời tin nhắn thì Galaxy A14 còn có thể đáp ứng khả năng duy trì lên tới hai ngày liên tục.	Còn đối với những bạn chỉ sử dụng để nghe gọi hay trả lời tin nhắn thì Galaxy A14 còn có thể đáp ứng khả năng duy trì lên tới hai ngày liên tục .

Về tốc độ sạc thì đây không hẳn là một điểm ấn tượng trên Samsung Galaxy A14 5G.	Về tốc độ sạc thì đây không hẳn là một điểm ấn tượng trên Samsung Galaxy A14 5G .

Máy chỉ được trang bị công suất sạc 15W, mất khoảng 1 tiếng 55 phút là có thể sạc đầy máy rồi.	Máy chỉ được trang bị công suất sạc 15W , mất khoảng 1 tiếng 55 phút là có thể sạc đầy máy rồi .

alt: Đủ cho một ngày dài sử dụng trong việc lướt web hay xem phim	alt : Đủ cho một ngày dài sử dụng trong việc lướt web hay xem phim

des: Đủ cho một ngày dài sử dụng trong việc lướt web hay xem phim	des : Đủ cho một ngày dài sử dụng trong việc lướt web hay xem phim

3.	3 .

Giá bán điện thoại Samsung Galaxy A14 5G tại TGDĐ	Giá bán điện thoại Samsung Galaxy A14 5G tại TGDĐ

Điện thoại Samsung Galaxy A14 5G hiện tại đang được bán tại Thế Giới Di Động với mức giá  5.190.000 đồng .	Điện thoại Samsung Galaxy A14 5G hiện tại đang được bán tại Thế Giới Di Động với mức giá 5.190.000 đồng .

alt: Đây là mức giá bán tầm trung của phân khúc điện thoại	alt : Đây là mức giá bán tầm trung của phân khúc điện thoại

des: Đây là mức giá bán tầm trung của phân khúc điện thoại	des : Đây là mức giá bán tầm trung của phân khúc điện thoại

4.	4 .

alt: Ưu đãi khi mua điện thoại Samsung	alt : Ưu đãi khi mua điện thoại Samsung

des: Ưu đãi khi mua điện thoại Samsung	des : Ưu đãi khi mua điện thoại Samsung

LƯU Ý : Bạn có thể cập nhật chi tiết chính sách bảo hành của Thế Giới Di Động  TẠI ĐÂY .	LƯU Ý : Bạn có thể cập nhật chi tiết chính sách bảo hành của Thế Giới Di Động TẠI ĐÂY .

Bài viết trên đây đã giúp bạn đánh giá chi tiết Samsung Galaxy A14 5G: Có gì đáng để mong đợi?	Bài viết trên đây đã giúp bạn đánh giá chi tiết Samsung Galaxy A14 5G : Có gì đáng để mong đợi ?

Hẹn gặp lại bạn ở các bài viết sau!	Hẹn gặp lại bạn ở các bài viết sau !

